1111111111111
1000000000001
100000P0ECP00
1111111111111