1111111111111
10000000E0001
1111110111111
100000000CP01
1111111111111