1111111111111
1000000000001
100000P0ECP01
1111111111111